eeeeeeeeeeeeeeeeeeee
eC     xC     xC   e
eC     |      x    e
e      x E   Cx    e
e   E  x    xxx E  e
e    E             e
ex-xxxxxxx  Exxx-x e
e            xC  x e
e     E      xx  x e
e             x    e
eeeeeeeeeeeeeeeeeeeef
